0,1,2,3,4,5,6,7,8,9,10,11
0,0,0,1,1,1,1,1,1,0,0,0
0,0,0,1,0,0,0,0,1,1,1,0
0,0,0,1,0,3,0,0,0,0,1,0
0,1,1,1,0,3,0,1,1,0,1,0
0,1,2,2,2,0,3,0,0,0,1,0
0,1,2,2,2,3,1,3,0,1,1,0
0,1,1,1,1,0,1,0,3,0,1,0
0,0,0,0,1,0,0,4,0,0,1,0
0,0,0,0,1,1,1,1,1,1,1,0
0,0,0,0,0,0,0,0,0,0,0,0
0,0,0,0,0,0,0,0,0,0,0,0
0,0,0,0,0,0,0,0,0,0,0,0
